{
  "width": 10,
  "height": 10,
  "player": {
    "x": 5,
    "y": 5
  },
  "world": [
    ["#", "#", "#", "#", "#", "#", "#", "#", "#", "#"],
    ["#", ".", ".", ".", ".", ".", ".", ".", ".", "#"],
    ["#", ".", ".", ".", ".", ".", ".", ".", ".", "#"],
    ["#", ".", ".", "#", "#", ".", ".", ".", ".", "#"],
    ["#", ".", ".", "#", "#", ".", ".", "i", ".", "#"],
    ["#", ".", ".", ".", ".", ".", ".", ".", ".", "."],
    ["#", ".", ".", ".", ".", ".", ".", ".", ".", "."],
    ["#", ".", ".", ".", ".", ".", ".", "N", ".", "#"],
    ["#", ".", ".", ".", ".", ".", ".", ".", ".", "#"],
    ["#", "#", "#", "#", "#", "#", "#", "#", "#", "#"]
  ]
}
